Modifier	调整值	骰点的加法修正值，包括增益减益
natural 20	投20	投骰结果为20
natural 1	投1	投骰结果为1
ability	属性
Strength	力量	力量属性
Dexterity	敏捷	敏捷属性
Constitution	体质	体质属性
Intelligence	智力	智力属性
Wisdom	感知	感知属性
Charisma	魅力	魅力属性
STR	力	力量属性缩写
DEX	敏	敏捷属性缩写
CON	体	体质属性缩写
INT	智	智力属性缩写
WIS	感	感知属性缩写
CHA	魅	魅力属性缩写
bonus	加值	检定正数调整值
penalty	减值	检定负数调整值
initiative checks	先攻检定
initiative	先攻
save	豁免
reflex	反射	条件反射，反应
fortitude	强韧	实体攻击的抵抗力
drain	吸取
helpless	无助
charms	魅惑
compulsions	胁迫
phantasms	魅影幻觉	只有施者和受者才能看到的幻象
patterns	心灵幻觉	心智上感受的幻觉
allegiance	阵营
law	守序
chaos	混乱
good	善良
evil	邪恶
occupation	职业背景
class	职业
class skill	本职技能
feat	专长
bonus feat	奖励专长	从专长列表中挑一个，这个bonus不是加值
competence bonus	表现加值
Academic	学者	职业背景
Computer Use	计算机使用
Craft	制造
Decipher Script	文件解读
Gather Information	收集信息
Knowledge	知识
arcane	秘法
lore	学识
civics	政法
Bluff	唬骗
Climb	攀爬
Demolitions	爆破
Disable Device	解除装置
Escape Artist	脱逃
Intimidate	威吓
Jump	跳跃
Move Silently	潜行
streetwise	街头智慧
Pilot	驾机
Ride	骑术
Spot	侦察
Survival	生存
Treat Injury	医疗
Proficiency	擅长
Brawl	拳法
Tumble	翻滚
structural	结构
electronic	电子
mechanical	机械
Handle Animal	驯养动物
Repair	修理
Blue Collar	蓝领
Athlete	运动员
Adventurer	探险家
Celebrity	名流
visual art	视觉艺术
Diplomacy	交涉
Disguise	易容
Perform	表演
act	演戏
stand-up	单口相声
sing	唱歌
act	演戏
Forgery	伪造文书
Hide	躲藏
Sleight of Hand	手上功夫
Criminal	罪犯
Creative	创作者（背景）
Dilettante	富二代
pharmaceutical	配药
Emergency Services	应急人员
Doctor	医生
Entrepreneur	企业家
Investigative	调查员
Investigate	调查
Sense Motive	察言观色
Law Enforcement	执法人员
tactics	策略
Listen	聆听
Combat Martial Arts	实战武术
Armor Proficiency (light)	擅长护甲（轻型）
Navigate	寻路
Religious	宗教人士
Military	军人
Rural	农户
Student	学生
current events	时事
Reputation	声望
Reputation check	声望检定
Fame	威名
Infamy	骂名
wealth	财富
check	检定
Windfall	横财
hero	英雄	PC，玩家的角色，统一译英雄了
Profession	专业
take 10	取10
take 20	取20
Aid Another	协助他人
sale value	售价
defense	防御
attack roll	攻击骰
flat-footed	措手不及
armor	护甲
Touch Attacks	接触攻击
Size	体型
dodge	闪避
deflection	偏斜
level	等级
massive	巨大（伤害）	这个字眼可能代表巨创
poison	毒素
paralysis	麻痹
talent	天赋
feature	专长
death	死亡
dying	濒死
heal	治疗
Hit point	生命值
disabled	瘫痪
dying	濒死
dead	死亡
Massive Damage	巨创
Improved Damage Threshold	巨创阈值增强
critical hit	重击
immune	免疫
dazed	眩晕
unconscious	昏迷
full-round action	整轮动作
round	轮	所有角色都过一遍
turn	回合	轮到一个玩家的行动时段
stable	稳定
Damage	伤害
condition	状态
effective	效果上的
Blinded	目盲
miss	失手
Search	搜索
Cowering	畏缩
Deafened	耳聋
Entangled	纠缠
charge	冲锋
run	奔跑
Exhausted	力竭
Fatigued	疲乏
attack of opportunity	借机攻击
Paralyzed	麻痹
coup de grace	致命一击
Nauseated	反胃
Pinned	压制
Prone	俯卧
Shaken	战栗
Stunned	震慑
environment	环境
hazard	险情
Heat	炎热
Cold	寒冷
Darkness	黑暗
Light	光明
counteracts	抵御
Starvation	饥饿
Thirst	口渴
Suffocation	窒息
Drown	溺水
Smoke	烟雾
choke	呛气
Strangulation	扼喉
Colossal	超巨型
Gargantuan	巨型
Huge	超大型
Large	大型
Medium-size	普通
Small	小型
Tiny	超小型
Diminutive	微型
Fine	超微型
chemical	化学
rank	级数	技能的等级
cross-class skill	跨职技能
Fort Save	强韧豁免	fortitude save的缩写
Ref Save	反射豁免	reflex save 的缩写
Will	意志
equipment	装备
popular culture	流行文化
Read/Write Language	读写语言
Speak Language	口头语言
Simple Weapons Proficiency	擅长简单武器
Extreme Effort	竭尽全力
Improved	精通
Improved Extreme Effort	精通竭尽全力
Prerequisite	要求
Ignore Hardness	无视硬度
Advanced	高级
Melee Smash	近战强击
Animal Affinity	动物亲和
Archaic Weapons Proficiency	擅长古典武器
Athletic	竞技
Blind-Fight	盲斗
Cleave	顺势斩
Combat Reflexes	战斗反射
Great Cleave	强力顺势斩
Power Attack	猛力攻击
Focus	专攻~
Weapon Focus	专攻武器
Drive	驾驶
Evasion	反射闪避
Uncanny Dodge	直觉闪避
flank	夹击
Defensive Roll	防御翻滚
Opportunist	乘势攻击
Acrobatic	杂技
Combat Expertise	寓守于攻
Combat Throw	摔投技巧
Defensive Martial Arts	防御武术
Double Tap	双发快射
Elusive Target	凌波微步
Focused	全神贯注
Disarm	卸除武器
Mobility	灵活移动
Personal Firearms	单兵枪械
Point Blank Shot	近程射击
Stealthy	隐秘
Weapon Finesse	武器娴熟
Damage Reduction	伤害减免
Increased Speed	加速
Unbreakable	不破金身
Resistance	抗力
Energy Resistance	能量抗力
Sonic	音波
Concussion	震荡
Remain Conscious	维持意识
Robust	健硕
Second Wind	回春
Stamina	耐力
Alertness	警觉
Confident	自信
Endurance	坚忍
Great Fortitude	强韧加强
Great	xx加强	Great xx = xx加强
Bull Rush	冲撞
Feint	虚招
Knockout Punch	终结之拳
Streetfighting	街头战斗
Toughness	健壮
Vehicle Expert	载具专家
writing	写作
arcane lore	秘法学识
art	艺术
behavioral sciences	行为科学
business	商学
earth and life sciences	地球与生命科学
history	历史
physical sciences	物理科学
theology and philosophy	神学与哲学
Research	研究
Savant	学者
Trained Only	需受训
Linguist	语言专家
Strategy	战略
Exploit Weakness	寻找破绽
surprise	突袭
circumstance	情景
Trick	诡计
Plan	计划
mind-affecting	影响心灵
Builder	构造师
Cautious	谨慎
Educated	良好教育
Gearhead	技术宅
Trip	绊摔
Iron Will	钢铁意志
Lightning Reflexes	闪电反射
Meticulous	一丝不苟
Studious	好学
Gamble	赌博
Empathic	移情
Empathic	移情
Empathy	移情
Intuition	直觉
medical kit	医疗箱
surgery kit	手术箱
Healing Touch	救死扶伤
Healing Knack	治疗诀窍
Insightful	洞见
Emphasis	专精
Skill Emphasis	技能专精
Aware	觉察
Faith	信念
Cool Under Pressure	沉着
Advanced Firearms Proficiency	高级擅长枪械
Attentive	听者有心
Deceptive	欺诈
Far Shot	远程射击
Medical Expert	医药专家
Surgery	手术
Track	追踪
dance	舞蹈
keyboards	键盘乐器
percussion instruments	打击乐器
stringed instruments	弦乐器
wind instruments	管乐器
indifferent	不关心
unfriendly	不友善
hostile	敌对
Favor	求援
plot	情节
threaten	威胁
Fast-Talk	花言巧语
Dazzle	虚张声势
Taunt	嘲讽
Leadership	领导
Coordinate	协调
Inspiration	激励
morale	士气
Agile Riposte	借机反击
Creative	富有创意（专长）
Frightful Presence	气势凶猛
Low Profile	低调
Renown	闻名
Trustworthy	值得信赖
Multiclass	跨职
multiple attacks	多次攻击
Base Attack Bonus	基础攻击加值
advanced class	高级职业
Soldier	士兵
Martial Artist	武术家
Gunslinger	枪手
Infiltrator	渗透者
Daredevil	勇士
Bodyguard	保镖
Field Scientist	战地科学家
Techie	技师
Mage	法师
Field Medic	战地医生
Investigator	调查员
Acolyte	侍僧
Personality	明星
Negotiator	谈判专家
Action Point	行动点
swim	游泳
specialization	专精~
Weapon specialization	专精武器
Tactical aid	战术支援
critical	重击
Improved critical	精通重击
Improved reaction	快速反应
Greater	高等
Critical strike	致命重击
unarmed strike	徒手击打
grapple	擒抱
Burst Fire	点射
Exotic Melee Weapon	异种近战武器
threat range	重击威胁区间	要触发重击，攻击骰所必须触及的骰点区间，默认为20，若增加则向下变宽
Living weapon	人间兵器
Flying kick	飞踢
Flurry of blows	疾风连击
Iron fist	铁拳
Unbalance Opponent	晃倒对手
Close combat shot	枪斗术
Defensive position	防御位置
Lightning shot	连射
Sharp-shooting	穿杨
Bullseye	致命射击
Two-Weapon Fighting	双持
Dead Aim	屏息瞄准
Precise Shot	精准射击
Quick Draw	快速拔出
Quick Reload	快速装填
Shot on the Run	移动射击
Skip Shot	跳弹射击
Strafe	扫射
Balance	平衡
Sweep	扫瞄
Improvised Implements	不滞于物
Skill mastery	稳定发挥
Improvised weapon damage	举轻若重
Without a trace	销声匿迹
improvised weapon	临时武器
Nimble	灵巧
Concentration	专注
Fearless	无畏
Nip-up	起身
Action boost	行动加速
Adrenaline rush	肾上腺素激发
Delay damage	延缓伤害
Damage threshold	巨创阈值提升
fear	恐惧
free action	即时动作
Force Stop	逼停
Spring Attack	跳跃攻击
Surface Vehicle Operation	地表载具操作
Vehicle Dodge	载具闪避
Harm’s way	护卫
Combat sense	战斗直觉
Sudden action	突然行动
Defensive strike	防守反击
Blanket protection	防卫指导
insight bonus	洞察加值
technology	技术
Smart defense	机智防御
Scientific improvisation	就地取材
Minor breakthrough	细微进展
Smart survival	机智求生
Smart weapon	巧用武器
Major Breakthrough	重大突破
Jury-rig	应急维修
Extreme machine	极限过载
Build robot	造机器人
Mastercraft	大师级工艺
Vehicles	载具
maneuver	机动性，机动
robot	机器人
Components	部件
Manipulators	机械臂
Treads	履带	在制造机器人里的运动方式，显然不是指轮胎纹
Bipedal	双足
Quadruped	四足
Audio/visual sensor	视听装置
Creature	生物
mastercraft feature	大师级工艺功能
computers	计算机
electronic devices	电气设备
Medical specialist	医疗专精
Expert healer	急救妙手
Medical mastery	燃眉救护
Minor medical miracle	回春圣手
Profile	画像
Contact	联系
Nonlethal force	非致命武力
Discern lie	识破谎言
Sixth sense	第六感
Unlimited access	自由进出
Bonus class skill	奖励本职技能
Royalty	富贵
Winning smile	亲和
Compelling performance	带动情绪
opposed	对抗	opposed xx check
Conceal motive	隐藏动机
React first	先发制人
Talk down	劝和
No sweat	轻而易举
Sow distrust	挑拨离间
attitude	态度
helpful	提供帮助
friendly	友善
SHADOW SLAYER	暗影猎手
Detect Shadow	探查暗影
Shadow immunity	暗影免疫
Slayer weapon	猎影武器
Shadow enemy	影之天敌
Fast healing	快速痊愈
denizens of Shadow	暗影生物
campaigns	冒险
aura	气场
Faint	微弱
Moderate	中等
Overwhelming	凌厉
Strong	强烈
Aura Power	气场强度
Rating	能级
Shadow Aura	暗影气场
caster level	施法者等级
spell	法术
Magic	魔法
Outsider	异界生物类
Aberration	异怪类
construct	构装体类
dragon	龙类
elemental	元素类
undead	不死生物类
Lingers	残留	气场（aura）的残留
Shadow Slayer	暗影猎手
natural	天生
natural weapon	天生武器	生物自带的武器，比如爪子
Exotic Firearms	异种枪械
empower	强效化
magic weapon	魔化武器
enhancement bonus	增强加值
favored	专克	暗影猎手影之天敌专长，专克
Fey	精类	一种生物种类
Giant	巨人类
Humanoid	类人生物类
Lycanthrope	兽化人类
Magical beast	魔法兽类
Monstrous humanoid	人形怪物类
restore	恢复
Word of slaying	猎影之言
attack action	攻击动作
Hit Dice	生命骰
OCCULTIST	术士
Smart hero	智力型英雄
STRONG HERO	力量型英雄
TOUGH HERO	体质型英雄
FAST HERO	敏捷型英雄
DEDICATED HERO	感知型英雄
CHARISMATIC HERO	魅力型英雄
Use Magic Device	使用魔法装置
Arcane skills	秘法技能
scrolls	卷轴
Bind	束缚
Bind Shadow creature	束缚暗影生物
Banish	驱除
normal	一般
Try Again	重试
Special	特别
distraction	分心
lost	丧失
defensively	防御姿态
wand	魔杖
spellbook	法术书
read a spell	解读施放	解读写好的法术，解读后这个法术会施放出来
emulate	模仿
Activate blindly	盲目启用
Decipher a written spell	解读写好了的法术
Emulate class feature	模仿职业专长
Emulate ability score	模仿属性值
Emulate allegiance	模仿立场
Use a scroll	使用卷轴
mishap	严重失误
Spellcraft	辨识法术
Mage	法师
divine	神术
scribe scroll	抄录卷轴
Shadow contact	暗影联系
contact	联系人
HD	生命骰	基础生命上限
vermin	虫类
animal	动物
type	种类
outward attitude	公开态度
inward	内心
wondrous item	奇物
magic	魔化	做形容词修饰武器、盔甲时为“魔化”
Shadow dimension	暗影位面
dimension	位面
TELEPATH	异能者
Wild Talent	特异功能
Autohypnosis	自我催眠
Psicraft	辨识灵能
Psionic skills	灵能技能
Psionic	灵能
psionic powers	灵力
Trigger power	触发灵力
Combat manifestation	战斗释放
Maximize power	极效灵力
Resist fear	抵御恐惧
Memorize	记忆
Tolerate poison	忍耐毒素
Willpower	坚定意志
8 1/2-by-11-inch sheet of paper	8.5乘11英寸大小的纸	美制A4纸的大小
secondary damage	再次伤害
manifest	释放灵力
power level	灵力等级
move action	移动动作
Telepath	异能者
psionic effect	灵能效果
power point	灵力点数
Power crystal	灵力水晶
encode	灌注	将灵力灌注至灵力水晶
maximum effect	极效	极效的灵力
Battle Mind	灵战士
Psi-blade	灵能战刃
imprint tattoo	刻印文身
Psychic shield	灵能护盾
Ultimate psi-blade	终极灵能战刃
piercing damage	穿刺伤害
experience point	经验值
summon familiar	召唤魔宠
familiar	魔宠
brew potion	调制药水
potion	药水
Scribe tattoo	书写文身
Spell mastery	法术熟稔
Combat casting	战斗施法
Maximize spell	极效法术
alchemy	炼金术
detect magical aura	侦测魔法气场
school	学派
read magic	阅读魔法
reaction	反应	反应，不需要动作
master	主人	魔宠的主人
Familiar Qualities	魔宠品质
touch range spell	远程接触法术
Empathic Link	情感连接
Share Spells	共享法术
Familiar’s Intelligence	魔宠智力
Natural Armor	天生护甲
deliver touch spells	传递接触法术
touch spell	接触法术
cast	施展（法术）
dissipates	消散
Ferret	鼬
Hawk	猎鹰
viper	毒蛇
target of the spell	受术者
FX Abilities	超自然能力
Holy Symbol	神符
turn	驱散	驱散不死生物
rebuke	斥喝	斥喝（不死生物）
Turn or rebuke undead	驱散或斥喝不死生物
Spontaneous cast	自发施法
Turn or rebuke	驱散或斥喝
zombies	僵尸
skeletons	骷髅
ghosts	幽魂
vampires	吸血鬼
total cover	完全掩蔽
mental control	心灵控制
Dispel Turning	解除驱散
Bolster Undead	鼓舞不死生物
cure spell	治疗法术
inflict spell	造成伤害法术
Ordinaries	路人
Challenge Rating	挑战等级
allies	盟友
antagonists	对手
Heroic supporting character	英雄非玩家角色
Benefit	效果	专长的效果
Normal	正常
melee weapon	近战武器
ranged weapon	远程武器
Aircraft Operation	飞行器操作
heavy aircraft	重型飞行器
helicopters	直升机
jet fighters	喷气战斗机
spacecraft	太空飞船
jumbo passenger airplanes	巨型客机
large cargo planes	大型货运飞机
non-proficient penalty	不擅长减值
concealment	隐藏
miss chance roll	失手几率骰
Unarmed	徒手
drop	倒下
5-foot step	五尺快步
fight defensively	防御式战斗
Drive-By Attack	驾驶攻击
cannon	加农炮
heavy machine gun	重机枪
grenade launcher	榴弹发射器
rocket launcher	火箭筒
Scale	尺度	不同情景适用不同的距离单位
Stunt	特技	驾驶特技
Bootleg Turn	甩尾
driver	驾驶员
sideswipe	侧击
turn number	转向距离	车辆转向之前必须径直移动的距离。
stationary speed	静止速度
Guide	向导
Heroic Surge	英勇
provoke	引发	引发借机攻击指的都是给对方借机攻击的机会，自己利用借机攻击机会的是“进行借机攻击”
threatened squares	威胁范围	借机攻击的威胁方格区域
full normal rate of attacks	正常攻击速度
long jump	跳远
heavy load	重度负载
Sunder	击碎
heavy wheeled	重型轮式载具
powerboat	汽艇
sailboat	帆船
ship	舰
tracked	履带式载具
semi-trucks	半挂牵引车
armored personnel carrier	装甲输送车
wheeled armored vehicle	轮式装甲车
wheeled construction vehicle	轮式重机
military vehicle	军用载具
surface vehicle	地表载具
Very soft	异常松软	地面情况
Soft	松软	地面情况
Firm	坚实	地面情况
Hard	坚硬	地面情况
rapier	细剑
chain	锁链
Whirlwind Attack	旋风攻击
Skill	技能
skill point	技能点
buy	提升	buy a skill不翻“购买技能”而是“提升技能”
miscellaneous	其他
Very easy	非常容易
Easy	容易
Average	一般
Tough	棘手
Challenging	有挑战性
Formidable	难以克服
Heroic	英雄壮举
Superheroic	天降大任
Nearly impossible	难于登天
commando	突击队
Skill Synergy	技能共效
synergy	共效
Stack	叠加
cover	掩蔽
competence	表现
enlargement	巨化
haste	加速术
inherent	固有
haste bonus	加速加值
insight bonus	洞见加值
profane	亵渎
sacred	神圣
descriptor	学名
Skill Description	技能描述
Untrained	未受训
Time	时间
fall	坠落
full speed	常速	全速就是常速
precarious surface	不稳定的表面
Favorable	有利
unfavorable	不利
Handholds	把手点
Footholds	脚踏点
piton	岩钉
rope	绳索
load	负载
discretion	自由裁量
chain-link fence	铁丝网栅栏
air duct	通风管
slippery	光滑的
Find File	查找文件
Find File	查找文件
Defeat Computer Security	破解计算机防御
Hack	黑入
site	站点
session	会话
Covering Tracks	掩盖踪迹
Access	访问
Internet Access	网络访问
Physical Access	物理访问
Locate What You’re Looking For	锁定目标位置
Defeat File Security	破解文件锁
Do Your Stuff	进行操作
Defend Security	主动防御
Degrade Programming	破坏性编程
Crashing	使崩溃
Destroying programming	损毁性编程
Damaging programming	损伤性编程
Write Program	编写程序
Operate Remote Device	操作远程设备
remote	遥感
acid	酸
base	盐基
explosive	爆炸物
substance	物质
from scratch	从零开始，土法制造
Improvised	临时的
Powerful	大威力的	爆炸物
Devastating	毁灭性的	爆炸物
concussion	震荡
Scratch-Built Explosive	土制爆炸物
Poisonous Substances	毒素
Solid poison	固体毒素
Liquid poison	毒液
Initial Damage	初始伤害
Restriction	限制级
ingest	摄取
Arsenic	砒霜
license	执照
Atropine	阿托品
Injury	创伤
Belladonna	颠茄
Blue vitriol	蓝矾
Blue-ringed octopus venom	蓝环章鱼毒液
Chloral hydrate	水合氯醛
Chloroform	氯仿
Inhaled	吸入
Curare	箭毒
Cyanide	氯化物
Cyanogen	氯气
DDT	滴滴涕
Knockout gas	窒息性毒气
Lead arsenate	砷酸铅
Mustard	芥末
Paris green	巴黎绿
Rattlesnake	响尾蛇
Sarin nerve gas	沙林神经毒气
Strychnine	番木鳖碱
unwilling	不情愿的
timer	计时器
detonator	起爆器
radio direction finder	无线电测向仪
Scratch-Built	土制
tripwire trap	绊线陷阱
electrical tool kit	电气工具
medicinal drug	药物
pharmacist kit	配药箱
chemical kit	化学工具
mechanical tool kit	机械工具
bookcase	书架
catapult	投石车
shed	小棚屋
house deck	地板
bunker	仓房
domed ceiling	拱形天花板
disarming	拆除
demolitions kit	爆破工具
aid	协助
Bribery	贿赂
Bouncer	保安
Bureaucrat	官僚
Informant	告密者
Police officer	警官
lockpick set	橇锁工具
electric fence	电栅栏
motion sensor	运动感应器
security camera	安全摄像头
car opening kit	撬车工具
lock release gun	破锁枪
Cheap	廉价
Average	一般
High quality	高质量
High security	高度安全
Ultrahigh security	顶级安全
Child	儿童
Young adult	青少年
Adult	青年
Middle age	中年
Old	老年
Venerable	高年
disguise kit	易容工具
Driving a Vehicle	驾驶载具
motor vehicle	机动载具
restraint	束缚
Handcuffs	手铐
Tight space	狭小的空间
airshaft	通风竖井
forgery kit	伪造工具
stake	赌注
penny-ante	小赌
astronomical	大赌
General	传闻	信息类型
Specific	专门	信息类型
Restricted	受限	信息类型
Protected	受保护	信息类型
Handle an animal	驾驭动物
“Push” an animal	逼迫动物
Teach an animal a trick	教会动物一个技巧
Train an animal for a purpose	为通用工作训练动物
trick	技巧	驯养动物
task	工作	驯养动物
Come	过来	驯养动物
Defend	防御	驯养动物
Down	退让	驯养动物
Fetch	取物	驯养动物
Guard	看守	驯养动物
Heel	跟随	驯养动物
Seek	搜寻	驯养动物
Stay	停留	驯养动物
Track	追踪	驯养动物
Work	劳作	驯养动物
medium	中度	负载
purpose	（动物的）工作	驯养动物
Combat Riding	战斗骑乘
Fighting	战斗	驯养动物，工作
Guarding	守护	驯养动物，工作
Laboring	干重活	驯养动物，工作
Hunting	捕猎	驯养动物，工作
Riding	骑乘	驯养动物，工作
Tailing	尾随
crime lab	技术鉴定室
evidence kit	取证工具
Hop Up	跳台阶
Language Group	语族
temporary repair	临时修理
hot-wire	热线发动
topic	课题
Guide with Knees	用膝控制
Stay in Saddle	待在鞍上
Fight while Mounted	战斗中控制坐骑
Cover	掩蔽	骑术检定
Soft Fall	软着陆
Leap	跳跃	骑术
Long-Term Care	长期护理
Restore Hit Points	恢复生命值
Revive	救醒	医疗技能
first aid kit	急救箱
Stabilize	稳定
total defense	全防御
Su	超自然能力	特殊能力的一种
Ex	特异能力	特殊能力的一种
Ability Score	属性值
Permanent Ability Drain	永久属性流失
Ability Score Reduction	属性值减少
temporary hit points	暂时生命值
Blindsight	盲视
Invisibility	隐形
Breath Weapon	喷吐武器
Species Traits	物种特性
Constrict	紧勒
improved grab	精通攫抓
Damage Reduction	伤害减免
Darkvision	黑暗视觉
negative level	负向等级
Energy Drain	能量吸取
Fear Aura	恐惧气场
freeze	冻结
panicked	恐慌
Gaze	凝视
petrification	石化
hold	缠握
Low-Light Vision	低光视觉
Power Resistance	灵能抗力
spell-like ability	类法术能力
Sp	类法术能力
Regeneration	再生
Scent	灵敏嗅觉
Overpowering	极重
activate	启动（魔法物品）
Swallow Whole	活吞
bitten	啮咬
Trample	践踏
bludgeon	钝击
Turn Resistance	驱散抗力
On-Hand Objects	寻常物品
Restricted	管制
Military	军用	物品管制等级
Illegal	非法
Requisitioning	申调
holster	装具
Carrying Capacity	负重能力
Light Load	轻度负载
encumbered	累赘
heavily encumbered	重度累赘
Lift	举重
Drag	拖行
General Equipment	普通装备
Size	尺寸	物品
Weight	重量
Aluminum travel case	铝制旅行箱
Briefcase	公文包
Day pack	双肩包
Handbag	手提包
Contractor’s field bag	工程包
Range pack	战术背包
Patrol box	巡逻箱
Clothing outfit	套装
Outerwear	外套
Parka	派克大衣
Photojournalist’s vest	摄影马甲
Windbreaker	防风夹克
Tool belt	工具腰带
Walkie-talkie	对讲机
Caller ID defeater	电话匿名装置
Cellular interceptor	无线拦截器
Lineman’s buttset	接线工具
Night vision goggles	夜视仪
Tap detector	电话窃听检测器
Bolt cutter	断线钳
Duct tape	胶带
Zip-tie	约束带
Search-and-rescue kit	搜救工具
Spike strip	道路钉障
Binoculars	双筒望远镜
Flash goggles	防闪光护目镜
Battery flood	强光手电筒
Mesh vest	网眼背心
Trail rations	单兵口粮
Illuminator	挂载手电筒
Clothing	衣物
Business	公务装
Casual	便装
Formal	正装
Fatigues	作训服
Uniform	制服
Ghillie Suit	吉利服
Concealed Weapons and Objects	隐蔽的武器与物品
Fatigue Jacket	作训外套
Overcoat	大衣
Computers and Consumer Electronics	计算机与用电器
Camera	相机
35mm	35mm相机
Digital	数码相机
Disposable	拍立得相机
Film	胶片
Film Developing	胶片冲洗
Cell Phone	手机
Desktop	台式电脑
Notebook	笔记本电脑
Digital Audio Recorder	数码录音机
Modem	调制解调器
Broadband	宽带
Cellular	蜂窝网	Cellular
Portable Satellite Telephone	便携式卫星电话
Portable Video Camera	便携式摄像机
Surveillance Gear	监控设备
Black Box	小黑盒
Telephone Tap	电话窃听器
Line Tap	线路窃听器
junction box	接线箱
Receiver Tap	接收端窃听器
Telephone Line Tracer	电话线路跟踪器
Caltrops	铁蒺藜
avoid hazard	避险	驾驶特技
Fake ID	假身份
hardness	硬度
Multipurpose Tool	多功能工具钳
puncture-resistant tires	防刺轮胎
Survival Gear	生存装备
Backpack	背包
Standard	标准	双筒望远镜
Rangefinding	测距	双筒望远镜
Electro-Optical	光电	双筒望远镜
Chemical Light Stick	化学荧光棒
Climbing Gear	攀爬装备
Compass	指南针
Fire Extinguisher	灭枪械
Flashlight	手电筒
Penlight	小手电
Standard	标准	手电筒
Gas Mask	防毒面具
GPS Receiver	GPS接收器
Road Atlas	交通图
Tactical Map	战术地图
Portable Stove	便携炉
Sleeping Bag	睡袋
Tent	帐篷
Weapon Accessories	武器附件
Box Magazine	弹匣
fuse	导火索
Blasting cap	起爆雷管
Radio Control	遥控起爆器
Timed	计时	起爆器
Wired	线控	起爆器
Hip	腰部	装具（hip其实是臀部）
Concealed Carry	隐藏装具
Laser Sight	激光瞄具
Scope	瞄准镜
Standard	标准	瞄准镜
Electro-Optical	光电	瞄准镜
Speed Loader	快速装弹器
revolver	转轮枪
Suppressor	抑制器
Lifestyle	日常消费品
Small condo	小商品房
Large condo	大商品房
Small house	小平房
Medium house	中平房
Large house	大平房
Mansion	豪宅
Housing	居所
Family restaurant	家常菜馆
Upscale restaurant	高档饭店
Fancy restaurant	豪华饭店
Airfare	机票
Domestic, coach	国内经济舱
Domestic, first class	国内头等舱
International, coach	国际经济舱
International, first class	国际头等舱
Car rental	租车
Economy car	经适车
Mid-size	中型	车
Luxury	豪华车
Lodging	住宿
Budget motel	廉价汽车旅馆
Average hotel	平价酒店
Upscale hotel	高档酒店
Auto repair	机动车修理
Towing	拖车	机动车修理服务
Bail bonds	保释保证书
Property crime	财产犯罪
Assault crime	伤害罪
Death crime	杀人罪
Police officer	警官
Legal services	法律服务
Medical services	医疗服务
disabled	报废	载具的“瘫痪”
show up for his trial	出庭受审
splash	溅射
splash weapon	溅射武器
Handguns	手枪
longarm	长杆枪
whip	鞭子
Damage Type	伤害类型
Range Increment	射程跨度
Rate of Fire	射击模式
Single Shot	手动射击
Pump shotgun	泵动式霰弹枪
bolt-action rifle	栓动步枪
autofire	自动武器
Magazine	弹仓
Box	弹匣
Internal	内置型弹仓
Linked	弹链型弹仓
Cylinder	转轮型弹仓
bipod	两脚架
light weapon	轻武器
Beretta	伯莱塔	枪
Ballistic	实弹	伤害类型
autoloader	半自动	手枪，半自动手枪就是自动装填手枪，同一译半自动。
machine pistol	冲锋手枪
Lic	执照	限制级
Colt	柯尔特	枪
Colt Double Eagle	柯尔特双鹰
Colt Python	柯尔特巨蟒
Derringer	德林杰	手枪
Glock	格洛克	枪
MAC Ingram M10	MAC 英格拉姆 M10	冲锋手枪
Pathfinder	觅踪者	美国Charter Arms生产的民用手枪。这是一款冷门枪，暂时没找到国内官译
Ruger Service-Six	鲁格现役6型	手枪
S\&W	史密斯威森
SITES	赛茨	意大利产的小型手枪，全称SITES “Resolver” M9。暂无官译
Skorpion	蝎式冲锋枪
TEC-9	TEC-9冲锋枪
Walther PPK	瓦尔特PPK	自动手枪
assault rifle	突击步枪
Barrett	巴雷特
Barrett Light Fifty	巴雷特“轻50”M82A1
Benelli	贝纳利	Benelli摩托官译是贝纳利，同名军工厂虽然没有官译，但摩托厂和军工厂都是乔万尼·贝纳利创建的，所以取共享译名。
gauge	号	GAUGE这一计量单位没有中译名，作为对霰弹口径量度，都译为“号”。
Browning	勃朗宁
Mil	军用	管制等级（缩写）
Mossberg	莫斯伯格	霰弹枪
Remington	雷明顿
Sawed-off shotgun	锯短霰弹枪
Steyr	施泰尔	枪
Uzi	乌兹
Winchester	温彻斯特
Heavy Weapon	重武器
rocket launcher	火箭筒
grenade launcher	榴弹发射器
Compound bow	复合弓
Piercing	穿刺
Crossbow	弩
Flamethrower	火焰喷射器
Fire	火焰	伤害类型
Javelin	标枪
Pepper spray	辣椒喷雾器
Shuriken	手里剑
Taser	电击枪
Electricity	电	伤害类型
Slashing	劈砍	伤害类型
three-round burst	三发点射
Desert Eagle	沙漠之鹰
caliber	口径
recoil	后座力
Intratec	英特拉泰克	这美国枪企也没官方译名
hunting rifle	狩猎步枪
bore	孔径	枪管内径
Heckler & Koch	黑克勒科赫
HK	黑克勒科赫	枪
stock	枪托
grip	握把
bullpup	无托式
ambidextrous	双手通用
optical sight	光学瞄具
Model	型	枪
heavy-duty	重型
shaped charge	锥形装药
Grenade	榴弹
lever	杠杆
nozzle	喷嘴
rupture	破裂
irritant	刺激物
lethal	致命
Ammunition	弹药
buckshot	鹿弹
Crossbow bolt	弩箭
Burst Radius	爆炸半径
fragmentation grenade	破片榴弹/手雷
Semtex	塞姆汀	炸药厂商
C4/Semtex	C4/塞姆汀炸药
Det cord	引信
Dynamite	炸药
Smoke grenade	烟雾弹
Tear gas grenade	催泪弹
Thermite grenade	铝热弹
White phosphorus grenade	白磷弹
mild	弱	酸性
Molotov cocktail	莫洛托夫鸡尾酒
spray	喷洒
shrapnel	弹片
slab	板
wax	蜡
translucent	半透明的
knead	揉捏
yard	码	一码=3英尺
simple	简单	爆炸物
lighter	打火机
total concealment	全隐蔽
flask	烧瓶
ceramic	陶瓷
caustic	腐蚀性的
rag	破布
Brass knuckles	指虎
Cleaver	菜刀
Club	木棒
Knife	小刀
Metal baton	甩棍
Sap	闷棍
Tonfa	卜字拐
Hatchet	手斧
Hatchet	手斧
fixed	已安装	刺刀的状态
Bayonet	刺刀
Longsword	长剑
Machete	弯刀
Spear	矛
Straight razor	刮脸刀
Sword cane	手杖剑
manriki-gusari	万力锁	日本的武器，锁链两头各有一个重物
Chain saw	链锯
Kama	日本镰	一种武器
Katana	打刀
Kukri	反曲刀
Nunchaku	双节棍
Three-section staff	三节棍
twin butterfly swords	合掌刀	咏春八斩刀（刀法）所用的武器
switchblades	弹簧刀
Pistol Whip	手枪托
Rifle Butt	步枪托
impromptu	临时的
Stun Gun	电棍
double weapon	双头武器
two weapons	双持武器
reach weapon	长型武器
fence	栅栏
shaft	柄
simple weapon	简单武器
Ashtray	烟灰缸
CD disk case	CD碟盒
paperweight	镇纸
softball	垒球
hubcap	轮毂盖
stool	凳子
hockey	曲棍球
nail gun	射钉枪
tire iron	撬胎棒
sawhorse	锯木梁
dumpster	大垃圾桶
cabinet	橱柜
soda machine	冷饮贩卖机
stoplight	红绿灯
absorb	吸收	伤害
shatter	粉碎
bend	弯折
archaic	古典
tactical	战术
concealable	隐藏
Leather jacket	皮夹克
Leather armor	皮甲
Light undercover shirt	轻型衬甲
Pull-up pouch vest	上拉式便携防弹衣
Undercover vest	衬甲背心
Concealable vest	内穿防弹衣
Chainmail shirt	锁链甲衫
Light-duty vest	轻型执勤背心
Tactical vest	战术背心
Plate mail	板链甲
Forced entry unit	攻坚套装
Crew	车组位
Passengers	乘员位
Cargo Capacity	货容量
square	方格
chase	追逐
Bell Jet Ranger	贝尔206A喷气突击队员	直升机
Bell Model 212	贝尔212型	直升机
prop	螺旋桨
Cessna 172 Skyhawk	塞斯纳172天鹰	螺旋桨飞机
Learjet Model 45	里尔喷气45型	商务喷气机
Acura	讴歌	汽车
sedan	轿车
Aston-Martin Vanquish	阿斯顿·马丁-万奎仕	车
coupe	轿跑/双座轿车
BMW	宝马
Chevrolet	雪佛兰
Chevrolet Cavalier	雪佛兰科沃兹
Chevrolet Corvette	雪佛兰科尔维特
Dodge Neon	道奇霓虹
Ford Crown Victoria	福特维多利亚皇冠
Jaguar	捷豹
Lamborghini Diablo	兰博基尼迪亚波罗
Mercedes	梅赛德斯
Volkswagen	大众
Jetta	捷达
wagon	旅行车	（RV）轿车后备箱与车顶齐平，但又不是SUV
Ducati	杜卡迪
Harley Davidson	哈雷戴维森	摩托
AM General	美国汽车综合公司
Hummer	悍马
Chevrolet Suburban	雪佛兰萨博班	未引进中国，无中文名
Dodge Caravan	道奇凯领
minivan	多功能休旅车
Ford Escape	福特锐际
pickup	皮卡
Toyota Tacoma	丰田塔科马
Civilian Water Vehicles	民用船只
Bayliner	贝琳娜	游艇
Capri	卡普里	意大利的一个岛，这里指游艇型号
runabout	轻型汽艇
Fairline	菲尔兰	游艇
Targa	塔尔加	菲尔兰游艇型号
cabin cruiser	大游艇
Sea-Doo	喜度	摩托艇
personal watercraft	摩托艇	单人开的汽艇
Armored truck	武装卡车
Honda TRX400FW	本田TRX400FW
ATV	沙滩车
Limousine	豪华轿车
Moving truck	大卡车
NABI	北美客车
APC	步兵战车
M1A2 Abrams	M1A2艾布拉姆斯
M2A2 Bradley	M2A2布雷德利
M113A1 Gavin	M113A1盖文
UH-60 Black Hawk	UH-60黑鹰
Huey helicopter	修伊直升机	Huey helicopter
fuselage	机身	飞机
cruise control	恒速控制	汽车会自动适应一个速度，脚可以离开油门
antilock brakes	防抱死
air bags	安全气囊
keyless entry	遥控门锁
cavalry scouts	机动侦察兵	美军把乘车或乘机进行机动的侦察兵沿用骑兵编制，所以这个词就是指乘坐载具的侦察兵兵种。
van	面包车
sport utility vehicle	运动型多用途车
stern	船尾
stretch	弹性的
stretch limo	加长豪华轿车
rental	租赁
hatch	舱口
gunner	射击手	车组成员
Single	手动	射击模式
combatant	作战者
Statistic	数据
attempt	试图
natural	自然骰
Range Penalty	距离减值
Multiplying Damage	伤害倍增
Bonus damage	额外伤害	除了主要伤害外，武器自带的其他附带伤害。
extra dice	额外骰
automatic hit	必然命中
innate	固有的
run all out	全力奔跑	以一个整轮动作奔跑
Special Initiative Action	特殊先攻动作
Special Attack	特殊攻击
Ready	准备	准备攻击
Crawl	匍匐
Full attack	全力攻击	用一个整轮动作来攻击
Overrun	闯越
Withdraw	撤退
Varies	可变
Delay	延迟
Two-Handed	双手	注意双手和双持的区别
Actions in Combat	战斗中的动作
Melee Attack	近战攻击
adjacent	相邻
nonlethal	非致命
fang	尖牙
engaged in melee	处于近战
Standing Up	站起
unencumbered	无负担的
base speed	基础速度
total darkness	完全黑暗
Passing Through	越过
bound	束缚
sleeping	沉睡
Chance	几率
unaware	未觉察
Knockout Blow	击倒攻击
firearm	枪械
interfere	干扰
Planted Explosives	安装式爆炸物
jetliner	喷气式客机
Simple wooden door	简易木门
Strong wooden door	坚固木门
Cinderblock	煤渣砖
Metal bars	金属条
Unattended	未受照管的	没有被带在、拿在角色身上的（物品）
tripped	被绊倒
disarmed	被缴械
Grabbing Objects	夺取物品
grab	攫抓
role	职能
Copilot	副驾驶
rear	后悬挂
maneuver modifier	机动调整值
Yacht	游艇
Racing bike	竞赛摩托车
dirt bike	越野摩托车
Firing Arcs	射击角度
alley speed	巷速
street speed	街速
highway speed	高速
all-out	极速
Declaring Speed	宣示速度
highway	公路
diagonally	斜向
speed category	速度档次
Simple Maneuver	简单机动
45-Degree Turn	45度转向
Ram	冲撞
collision	碰撞
weave in and out of traffic	在车流中穿梭
Sideslip	侧闪
Vehicle combat	载具战斗
oil slick	浮油
Dash	猛冲
Hard Brake	急刹车
Hard Turn	急转弯
Jump	飞跃	载具的跳跃
collision multiplier	碰撞乘数
Losing Control	失控
Spin	旋转
Roll	翻滚
Crew Quality	车组水平
Skilled	老练	车组水平
Expert	专家	车组水平
Ace	精锐	车组水平
destroyed	被摧毁
physical ability	肉体属性
special qualities	特殊能力
Mental ability	精神属性
ooze	泥形怪类
plant	植物类
species bonus	物种加值
Burrow	掘穴
rushed	匆忙
Perfect	完美	飞行机动性
Good	优秀	飞行机动性
Poor	不佳	飞行机动性
Clumsy	笨拙	飞行机动性
dive attack	俯冲攻击
Bite	啮咬
Claw or Rake	抓挠
Gore	抵撞
Slap or Slam	拍击
Sting	螯刺
Primary Attack	主要攻击	相当于人类的主手攻击
secondary attack	次要攻击	相当于人类的副手攻击
Multiattack	多重攻击
Fighting Space	战斗区域
extraordinary	特异能力
spell-like	类法术能力
supernatural	超自然能力
focus	专注	注意力集中的状态
verbal	需要姿势的	法术一般需要做一些姿势
somatic	需要言语的	一般施展法术需要吟唱
disrupted	扰乱
dispel	解除（法术效果）
Fantastic	奇幻
Nonabilities	空属性
Advancement	提升	生物生命骰
Animal	动物类
Occultist	术士
Good Save Bonus	优势豁免加值
Poor Save Bonus	劣势豁免加值
Good Saving Throws	优势豁免
necromancy	死灵系
Keen Sight	敏锐视觉
visual effect	可见性效果
illusion	幻术
necromantic	死灵术
Potent Venom	猛毒
acquired	援引
inherited	继承
Ape	人猿
CR	挑战等级	Challenge rating的缩写
hp	生命值	Hit points的缩写
Mas	巨创阈值	Massive damage threshold的缩写
Init	先攻	Initiative的缩写
Spd	速度	Speed的缩写
BAB	基础攻击加值	Base Attack Bonus
Grap	擒抱调整值	Grapple Modifier
Atk	主要攻击	Primary attack
Full Atk	全力攻击	Full Attack
FS	战斗区域	Fighting Space
Reach	触及范围
SQ	特殊能力	Special Qualities
AL	阵营	allegiance
SV	豁免	saves
AP	行动点	action points
Rep	声望	reputation
fly	飞行
Bat	蝙蝠
Bear	熊
Bugbear	熊地精
Goblin	地精
Possessions	装备	生物总览中，生物所自带的道具
hip holster	腰部装具
